111111111111111111
100100P00000C00011
101111111110011C11
101100010000C00011
101001111110111111
101000000000101111
100000011111101111
100000000000C00011
100001111110000001
100000000000C000C1
111111111100111001
11111E0000000E0001
111111111111111111
